6 6
1 1
6 6
1 1 1 1 1 X
1 1 1 1 1 1
1 1 1 X 1 1
1 1 1 X 1 1
8 8 1 X 1 1
7 8 1 1 1 1